......................
......................
............S.........
......................
......................
BBBBBBBBBBBBBBBBBBBBBB