L.................................
L.................................
...S.............B................
..................................
..................................
BBBBBBBBBBBBB.....................
L.......................B.........
L.................................
L.................................
L.................................
.................................B