L...................
B...S...............
D...................
G...................
MDDDDDDDDDDDDDDDDDDD
....................