L...............B...
B...S...............
....................
G...................
MDDDDDDDDDDDDDDDDDDD
....................